NO ./textures/ch1.xpm
SO ./textures/ch2.xpm
WE ./textures/ch3.xpm
EA ./textures/ch4.xpm

F 50,50,50
C 135,206,235

111111111111111111111111111111
100000000010000000000000000001
101111111010111111111111111101
101000001010100000000000000101
101011101010101111111111110101
101010001010101000000000010101
101010111010101011111111010101
101010100010101010000001010101
101010101110101010111101010101
101010100000101010100001010101
101011111111101010101111010101
101000000000101010100000010101
101111111110101010111111110101
100000000010101010000000000101
111111111010101011111111111101
100000001010101000000000000101
101111101010101111111111110101
101000101010100000000000010101
101010101010111111111111010101
101010101010000000000001010101
101010101011111111111101010101
101010101000000000000101010101
101010111111111111110101010101
101010000000000000010101010101
101011111111111111010101010101
101000000000000000010101010101
101111111111111111110101010101
10000000000000000000010N010101
101111111111111111111111111101
111111111111111111111111111111
