NO ./textures/giraffe
SO ./textures/jaguar
WE ./textures/snake
EA ./textures/snake2

F 63,43,11
C 39,78,19

11111111111111111
10000000000000001
10110100001011101
10100100001010101
10100111111010101
10100000000010101
10111110111110101
10000010100000101
11111010101111101
10000010100000101
10111110111110101
10100000000010101
10101111111110101
10100000000000101
10111111E11111101
10000000000000001
11111111111111111
