NO ./textures/pink1.xpm
SO ./textures/pink2.xpm
WE ./textures/pink1.xpm
EA ./textures/pink2.xpm

F 178,18,101
C 248,169,210

1111111111111111111111111111
1000000000000000000000000001
1011111110000000001111111101
1010000010000000001000000101
1010111010000000001011101101
1010101010000000001010100001
1010101000000000001010001101
1010100010000N00000000000001
1010001010000000001010101101
1000101010000000001010101101
1010111010000000001011101101
1010000010000000001000000101
1011111110000000001111111101
1000000000000000000000000001
1111111111111111111111111111
