NO ./textures/ch1.xpm
SO ./textures/ch2.xpm
WE ./textures/ch3.xpm
EA ./textures/ch4.xpm

F 20,20,20
C 10,10,30


111111111111111111111
100000000000000000001
101111111111111111101
101000000000000000001
101011111111111111101
101010000000000000101
1010111111111110W0101
101000000000000000101
101111111111111111101
100000000000000000001
111111111111111111111
