NO ./textures/bricks.xpm
SO ./textures/grass.xpm
WE ./textures/roofs.xpm
EA ./textures/tile.xpm

F 220,100,0

C 225,30,0

111111
1000N1
110011
111111
