NO ./textures/bricks.xpm
SO ./textures/grass.xpm
WE ./textures/roofs.xpm
EA ./textures/tile.xpm

F 128,128,128

C 102,204,255

111111
1000N1
110011
111111
