NO ./textures/co_no.xpm
SO ./textures/co_so.xpm
WE ./textures/co_we.xpm
EA ./textures/co_ea.xpm
F 128,128,128

C 102,204,255

111111111111111111111111
100000000000110000000001
101111111110110111111101
1010000000N0000000000101
101011111111111111110101
101010000000000000010101
101010011111111110010101
101010010000000001010101
101010010111111101010101
101010000000000000010101
101011111111111111110101
101000000000000000000101
101111111111111111111101
100000000000000000000001
111111111111111111111111