NO ./textures/bw_no.xpm
SO ./textures/bw_so.xpm
WE ./textures/bw_we.xpm
EA ./textures/bw_ea.xpm
F 128,128,128

C 102,204,255

111111111111111111111111
1N0001000001000001000001
100001011101011101011101
101111010101010101010101
100010000001000100000101
111010111011110101111101
101000001000100000001001
101111111011101111101011
100010000010101000100001
111110111110101011101111
100010100000001010000001
101110101111111010111111
101000101000000010100001
111111111111111111111111