                     NO ./textures/ch1.xpm
SO           ./textures/ch2.xpm
WE ./textures/ch3.xpm
EA ./textures/ch4.xpm
        F 86, 54,            31

C 247,231,206

NO ./textures/a1.xpm

11111111111111111111
10000010010000000001
10N00010010000011111
11111010011110010001
10000010000010010001
10111011111010010001
10101000001011110111
10101111101010000001
10000000100010111101
11111111111111111111